village_id,village_name,families_count,total_people,funds_allocated,funds_received,funds_pending,schemes_summary_json
1,Village-1,77,352,690144,497234,192910,"{""Awas+"": {""approved"": 7, ""pending"": 7}, ""Water+"": {""approved"": 13, ""pending"": 7}, ""Sanitation"": {""approved"": 4, ""pending"": 2}, ""Crop Insurance"": {""approved"": 4, ""pending"": 4}, ""PMAY"": {""approved"": 13, ""pending"": 7}, ""MGNREGA"": {""approved"": 6, ""pending"": 3}, ""Scholarship"": {""approved"": 12, ""pending"": 9}, ""Pension"": {""approved"": 7, ""pending"": 9}}"
2,Village-2,62,269,615351,537551,77800,"{""PMAY"": {""approved"": 5, ""pending"": 2}, ""Crop Insurance"": {""approved"": 4, ""pending"": 8}, ""Pension"": {""approved"": 10, ""pending"": 2}, ""Sanitation"": {""approved"": 5, ""pending"": 1}, ""Scholarship"": {""approved"": 7, ""pending"": 5}, ""Water+"": {""approved"": 4, ""pending"": 4}, ""Awas+"": {""approved"": 10, ""pending"": 3}, ""MGNREGA"": {""approved"": 3, ""pending"": 4}}"
3,Village-3,48,215,1902990,1508539,394451,"{""Sanitation"": {""approved"": 10, ""pending"": 4}, ""Pension"": {""approved"": 6, ""pending"": 5}, ""Water+"": {""approved"": 4, ""pending"": 0}, ""Scholarship"": {""approved"": 7, ""pending"": 3}, ""Crop Insurance"": {""approved"": 6, ""pending"": 3}, ""MGNREGA"": {""approved"": 3, ""pending"": 2}, ""Awas+"": {""approved"": 6, ""pending"": 7}, ""PMAY"": {""approved"": 3, ""pending"": 4}}"
4,Village-4,40,165,831682,455779,375903,"{""Scholarship"": {""approved"": 4, ""pending"": 3}, ""Pension"": {""approved"": 9, ""pending"": 2}, ""Crop Insurance"": {""approved"": 2, ""pending"": 0}, ""Sanitation"": {""approved"": 4, ""pending"": 2}, ""PMAY"": {""approved"": 2, ""pending"": 4}, ""MGNREGA"": {""approved"": 8, ""pending"": 2}, ""Water+"": {""approved"": 5, ""pending"": 2}, ""Awas+"": {""approved"": 2, ""pending"": 3}}"
5,Village-5,51,221,1957831,1568196,389635,"{""Pension"": {""approved"": 6, ""pending"": 9}, ""MGNREGA"": {""approved"": 13, ""pending"": 9}, ""Sanitation"": {""approved"": 6, ""pending"": 3}, ""PMAY"": {""approved"": 8, ""pending"": 3}, ""Crop Insurance"": {""approved"": 5, ""pending"": 3}, ""Awas+"": {""approved"": 8, ""pending"": 9}, ""Scholarship"": {""approved"": 3, ""pending"": 4}, ""Water+"": {""approved"": 5, ""pending"": 0}}"
6,Village-6,54,244,1505360,1363705,141655,"{""Awas+"": {""approved"": 9, ""pending"": 4}, ""Crop Insurance"": {""approved"": 5, ""pending"": 5}, ""Sanitation"": {""approved"": 4, ""pending"": 9}, ""PMAY"": {""approved"": 5, ""pending"": 7}, ""Pension"": {""approved"": 5, ""pending"": 3}, ""Scholarship"": {""approved"": 3, ""pending"": 4}, ""Water+"": {""approved"": 5, ""pending"": 6}, ""MGNREGA"": {""approved"": 4, ""pending"": 0}}"
7,Village-7,72,325,864074,448422,415652,"{""Water+"": {""approved"": 10, ""pending"": 5}, ""Crop Insurance"": {""approved"": 7, ""pending"": 3}, ""MGNREGA"": {""approved"": 8, ""pending"": 3}, ""Scholarship"": {""approved"": 12, ""pending"": 3}, ""PMAY"": {""approved"": 8, ""pending"": 2}, ""Sanitation"": {""approved"": 6, ""pending"": 5}, ""Awas+"": {""approved"": 4, ""pending"": 6}, ""Pension"": {""approved"": 4, ""pending"": 7}}"
8,Village-8,50,230,656648,189074,467574,"{""Awas+"": {""approved"": 7, ""pending"": 3}, ""Pension"": {""approved"": 6, ""pending"": 2}, ""PMAY"": {""approved"": 3, ""pending"": 6}, ""Sanitation"": {""approved"": 7, ""pending"": 5}, ""Crop Insurance"": {""approved"": 4, ""pending"": 4}, ""Water+"": {""approved"": 4, ""pending"": 4}, ""MGNREGA"": {""approved"": 8, ""pending"": 3}, ""Scholarship"": {""approved"": 3, ""pending"": 2}}"
9,Village-9,50,233,1900627,1677726,222901,"{""Crop Insurance"": {""approved"": 4, ""pending"": 7}, ""Sanitation"": {""approved"": 5, ""pending"": 3}, ""MGNREGA"": {""approved"": 8, ""pending"": 6}, ""Scholarship"": {""approved"": 4, ""pending"": 6}, ""Pension"": {""approved"": 7, ""pending"": 0}, ""PMAY"": {""approved"": 5, ""pending"": 3}, ""Water+"": {""approved"": 4, ""pending"": 5}, ""Awas+"": {""approved"": 2, ""pending"": 5}}"
10,Village-10,43,178,1583825,1151748,432077,"{""MGNREGA"": {""approved"": 7, ""pending"": 6}, ""PMAY"": {""approved"": 1, ""pending"": 3}, ""Sanitation"": {""approved"": 4, ""pending"": 5}, ""Water+"": {""approved"": 2, ""pending"": 5}, ""Scholarship"": {""approved"": 5, ""pending"": 3}, ""Crop Insurance"": {""approved"": 5, ""pending"": 2}, ""Awas+"": {""approved"": 6, ""pending"": 3}, ""Pension"": {""approved"": 4, ""pending"": 3}}"
11,Village-11,65,283,1548451,1108074,440377,"{""MGNREGA"": {""approved"": 12, ""pending"": 5}, ""Crop Insurance"": {""approved"": 10, ""pending"": 4}, ""Sanitation"": {""approved"": 5, ""pending"": 3}, ""Awas+"": {""approved"": 6, ""pending"": 3}, ""Pension"": {""approved"": 4, ""pending"": 1}, ""PMAY"": {""approved"": 11, ""pending"": 8}, ""Water+"": {""approved"": 9, ""pending"": 2}, ""Scholarship"": {""approved"": 6, ""pending"": 5}}"
12,Village-12,78,350,1853299,1655997,197302,"{""Awas+"": {""approved"": 8, ""pending"": 7}, ""Crop Insurance"": {""approved"": 4, ""pending"": 10}, ""Water+"": {""approved"": 6, ""pending"": 6}, ""MGNREGA"": {""approved"": 8, ""pending"": 4}, ""PMAY"": {""approved"": 12, ""pending"": 6}, ""Sanitation"": {""approved"": 3, ""pending"": 8}, ""Scholarship"": {""approved"": 10, ""pending"": 4}, ""Pension"": {""approved"": 7, ""pending"": 5}}"
13,Village-13,64,284,971747,895633,76114,"{""PMAY"": {""approved"": 6, ""pending"": 6}, ""Crop Insurance"": {""approved"": 4, ""pending"": 1}, ""Awas+"": {""approved"": 4, ""pending"": 5}, ""Scholarship"": {""approved"": 13, ""pending"": 6}, ""Sanitation"": {""approved"": 7, ""pending"": 2}, ""Water+"": {""approved"": 15, ""pending"": 7}, ""MGNREGA"": {""approved"": 9, ""pending"": 5}, ""Pension"": {""approved"": 8, ""pending"": 3}}"
14,Village-14,28,127,1799934,1333840,466094,"{""PMAY"": {""approved"": 4, ""pending"": 3}, ""Crop Insurance"": {""approved"": 3, ""pending"": 3}, ""Sanitation"": {""approved"": 2, ""pending"": 1}, ""Water+"": {""approved"": 6, ""pending"": 2}, ""MGNREGA"": {""approved"": 3, ""pending"": 3}, ""Scholarship"": {""approved"": 3, ""pending"": 2}, ""Pension"": {""approved"": 4, ""pending"": 1}, ""Awas+"": {""approved"": 2, ""pending"": 1}}"
15,Village-15,30,137,868865,433373,435492,"{""Crop Insurance"": {""approved"": 3, ""pending"": 5}, ""Scholarship"": {""approved"": 4, ""pending"": 3}, ""Sanitation"": {""approved"": 3, ""pending"": 3}, ""Water+"": {""approved"": 5, ""pending"": 2}, ""PMAY"": {""approved"": 3, ""pending"": 1}, ""Pension"": {""approved"": 5, ""pending"": 0}, ""Awas+"": {""approved"": 0, ""pending"": 1}, ""MGNREGA"": {""approved"": 0, ""pending"": 1}}"
16,Village-16,33,159,1280666,1185836,94830,"{""Crop Insurance"": {""approved"": 5, ""pending"": 2}, ""Scholarship"": {""approved"": 3, ""pending"": 3}, ""PMAY"": {""approved"": 7, ""pending"": 3}, ""Awas+"": {""approved"": 2, ""pending"": 1}, ""Water+"": {""approved"": 3, ""pending"": 1}, ""Pension"": {""approved"": 2, ""pending"": 5}, ""Sanitation"": {""approved"": 3, ""pending"": 2}, ""MGNREGA"": {""approved"": 4, ""pending"": 2}}"
17,Village-17,25,121,1669311,1178807,490504,"{""Pension"": {""approved"": 2, ""pending"": 0}, ""Scholarship"": {""approved"": 3, ""pending"": 2}, ""Crop Insurance"": {""approved"": 2, ""pending"": 3}, ""Sanitation"": {""approved"": 2, ""pending"": 3}, ""Awas+"": {""approved"": 2, ""pending"": 3}, ""PMAY"": {""approved"": 2, ""pending"": 2}, ""Water+"": {""approved"": 3, ""pending"": 0}, ""MGNREGA"": {""approved"": 1, ""pending"": 0}}"
18,Village-18,35,153,1256953,1110957,145996,"{""Pension"": {""approved"": 7, ""pending"": 1}, ""Sanitation"": {""approved"": 3, ""pending"": 2}, ""Awas+"": {""approved"": 2, ""pending"": 3}, ""Scholarship"": {""approved"": 4, ""pending"": 2}, ""Water+"": {""approved"": 6, ""pending"": 2}, ""PMAY"": {""approved"": 2, ""pending"": 6}, ""Crop Insurance"": {""approved"": 2, ""pending"": 4}, ""MGNREGA"": {""approved"": 3, ""pending"": 2}}"
19,Village-19,36,150,1792867,1667550,125317,"{""Awas+"": {""approved"": 4, ""pending"": 1}, ""MGNREGA"": {""approved"": 5, ""pending"": 2}, ""Crop Insurance"": {""approved"": 5, ""pending"": 4}, ""PMAY"": {""approved"": 2, ""pending"": 6}, ""Pension"": {""approved"": 5, ""pending"": 2}, ""Water+"": {""approved"": 4, ""pending"": 1}, ""Scholarship"": {""approved"": 4, ""pending"": 3}, ""Sanitation"": {""approved"": 8, ""pending"": 2}}"
20,Village-20,25,109,575185,202393,372792,"{""Sanitation"": {""approved"": 2, ""pending"": 2}, ""Crop Insurance"": {""approved"": 4, ""pending"": 1}, ""MGNREGA"": {""approved"": 4, ""pending"": 2}, ""PMAY"": {""approved"": 6, ""pending"": 3}, ""Pension"": {""approved"": 1, ""pending"": 1}, ""Water+"": {""approved"": 3, ""pending"": 1}, ""Awas+"": {""approved"": 1, ""pending"": 1}, ""Scholarship"": {""approved"": 5, ""pending"": 0}}"
21,Village-21,79,335,668760,455060,213700,"{""Crop Insurance"": {""approved"": 9, ""pending"": 9}, ""MGNREGA"": {""approved"": 7, ""pending"": 8}, ""Water+"": {""approved"": 7, ""pending"": 6}, ""Sanitation"": {""approved"": 19, ""pending"": 11}, ""Awas+"": {""approved"": 12, ""pending"": 8}, ""Scholarship"": {""approved"": 10, ""pending"": 5}, ""PMAY"": {""approved"": 12, ""pending"": 1}, ""Pension"": {""approved"": 2, ""pending"": 9}}"
22,Village-22,79,368,2200170,1974245,225925,"{""Scholarship"": {""approved"": 9, ""pending"": 7}, ""Water+"": {""approved"": 6, ""pending"": 11}, ""Sanitation"": {""approved"": 8, ""pending"": 6}, ""MGNREGA"": {""approved"": 7, ""pending"": 6}, ""Awas+"": {""approved"": 2, ""pending"": 7}, ""Crop Insurance"": {""approved"": 9, ""pending"": 8}, ""Pension"": {""approved"": 4, ""pending"": 2}, ""PMAY"": {""approved"": 6, ""pending"": 3}}"
23,Village-23,37,181,1580636,1149680,430956,"{""Water+"": {""approved"": 3, ""pending"": 2}, ""Scholarship"": {""approved"": 2, ""pending"": 2}, ""PMAY"": {""approved"": 5, ""pending"": 2}, ""Pension"": {""approved"": 2, ""pending"": 5}, ""Awas+"": {""approved"": 5, ""pending"": 1}, ""Sanitation"": {""approved"": 2, ""pending"": 2}, ""Crop Insurance"": {""approved"": 3, ""pending"": 4}, ""MGNREGA"": {""approved"": 5, ""pending"": 0}}"
24,Village-24,34,166,577037,233885,343152,"{""MGNREGA"": {""approved"": 3, ""pending"": 2}, ""Scholarship"": {""approved"": 3, ""pending"": 0}, ""Sanitation"": {""approved"": 3, ""pending"": 1}, ""Crop Insurance"": {""approved"": 4, ""pending"": 3}, ""PMAY"": {""approved"": 4, ""pending"": 3}, ""Water+"": {""approved"": 6, ""pending"": 5}, ""Pension"": {""approved"": 4, ""pending"": 2}, ""Awas+"": {""approved"": 3, ""pending"": 2}}"
25,Village-25,27,122,1772212,1298576,473636,"{""Pension"": {""approved"": 8, ""pending"": 3}, ""Scholarship"": {""approved"": 1, ""pending"": 1}, ""Sanitation"": {""approved"": 8, ""pending"": 4}, ""Awas+"": {""approved"": 4, ""pending"": 2}, ""PMAY"": {""approved"": 2, ""pending"": 3}, ""MGNREGA"": {""approved"": 7, ""pending"": 3}, ""Water+"": {""approved"": 2, ""pending"": 2}, ""Crop Insurance"": {""approved"": 2, ""pending"": 2}}"
26,Village-26,52,240,1827147,1428587,398560,"{""Awas+"": {""approved"": 4, ""pending"": 1}, ""Scholarship"": {""approved"": 8, ""pending"": 3}, ""PMAY"": {""approved"": 4, ""pending"": 3}, ""Sanitation"": {""approved"": 3, ""pending"": 7}, ""Crop Insurance"": {""approved"": 6, ""pending"": 5}, ""Pension"": {""approved"": 2, ""pending"": 6}, ""MGNREGA"": {""approved"": 4, ""pending"": 3}, ""Water+"": {""approved"": 6, ""pending"": 3}}"
27,Village-27,62,290,1258589,1158373,100216,"{""Scholarship"": {""approved"": 9, ""pending"": 4}, ""Pension"": {""approved"": 7, ""pending"": 6}, ""PMAY"": {""approved"": 6, ""pending"": 1}, ""MGNREGA"": {""approved"": 12, ""pending"": 7}, ""Awas+"": {""approved"": 6, ""pending"": 7}, ""Crop Insurance"": {""approved"": 2, ""pending"": 5}, ""Water+"": {""approved"": 5, ""pending"": 0}, ""Sanitation"": {""approved"": 2, ""pending"": 7}}"
28,Village-28,71,311,541066,510800,30266,"{""PMAY"": {""approved"": 15, ""pending"": 4}, ""MGNREGA"": {""approved"": 9, ""pending"": 10}, ""Pension"": {""approved"": 7, ""pending"": 3}, ""Awas+"": {""approved"": 5, ""pending"": 9}, ""Sanitation"": {""approved"": 8, ""pending"": 3}, ""Scholarship"": {""approved"": 8, ""pending"": 14}, ""Crop Insurance"": {""approved"": 13, ""pending"": 4}, ""Water+"": {""approved"": 5, ""pending"": 4}}"
29,Village-29,63,292,1869403,1574098,295305,"{""Scholarship"": {""approved"": 9, ""pending"": 5}, ""Crop Insurance"": {""approved"": 8, ""pending"": 2}, ""Pension"": {""approved"": 4, ""pending"": 5}, ""Sanitation"": {""approved"": 8, ""pending"": 9}, ""MGNREGA"": {""approved"": 3, ""pending"": 4}, ""Water+"": {""approved"": 5, ""pending"": 7}, ""Awas+"": {""approved"": 3, ""pending"": 6}, ""PMAY"": {""approved"": 2, ""pending"": 5}}"
30,Village-30,72,325,448652,295487,153165,"{""Sanitation"": {""approved"": 12, ""pending"": 8}, ""Pension"": {""approved"": 10, ""pending"": 6}, ""Crop Insurance"": {""approved"": 10, ""pending"": 6}, ""MGNREGA"": {""approved"": 7, ""pending"": 6}, ""PMAY"": {""approved"": 8, ""pending"": 10}, ""Scholarship"": {""approved"": 5, ""pending"": 4}, ""Water+"": {""approved"": 9, ""pending"": 5}, ""Awas+"": {""approved"": 5, ""pending"": 5}}"
31,Village-31,43,186,2212599,1719943,492656,"{""Water+"": {""approved"": 5, ""pending"": 6}, ""MGNREGA"": {""approved"": 5, ""pending"": 2}, ""Sanitation"": {""approved"": 4, ""pending"": 4}, ""Pension"": {""approved"": 5, ""pending"": 4}, ""Awas+"": {""approved"": 3, ""pending"": 5}, ""Crop Insurance"": {""approved"": 9, ""pending"": 2}, ""Scholarship"": {""approved"": 5, ""pending"": 1}, ""PMAY"": {""approved"": 4, ""pending"": 3}}"
32,Village-32,46,204,2258708,1917093,341615,"{""Sanitation"": {""approved"": 13, ""pending"": 9}, ""Scholarship"": {""approved"": 3, ""pending"": 8}, ""MGNREGA"": {""approved"": 6, ""pending"": 4}, ""PMAY"": {""approved"": 4, ""pending"": 4}, ""Crop Insurance"": {""approved"": 6, ""pending"": 5}, ""Water+"": {""approved"": 6, ""pending"": 4}, ""Awas+"": {""approved"": 6, ""pending"": 0}, ""Pension"": {""approved"": 4, ""pending"": 2}}"
33,Village-33,72,331,2145125,1724432,420693,"{""Pension"": {""approved"": 8, ""pending"": 7}, ""Awas+"": {""approved"": 9, ""pending"": 3}, ""Crop Insurance"": {""approved"": 9, ""pending"": 6}, ""Scholarship"": {""approved"": 12, ""pending"": 2}, ""Water+"": {""approved"": 11, ""pending"": 3}, ""MGNREGA"": {""approved"": 4, ""pending"": 4}, ""Sanitation"": {""approved"": 9, ""pending"": 3}, ""PMAY"": {""approved"": 6, ""pending"": 7}}"
34,Village-34,69,306,1841275,1719960,121315,"{""PMAY"": {""approved"": 10, ""pending"": 5}, ""MGNREGA"": {""approved"": 9, ""pending"": 6}, ""Pension"": {""approved"": 5, ""pending"": 11}, ""Water+"": {""approved"": 10, ""pending"": 3}, ""Sanitation"": {""approved"": 10, ""pending"": 2}, ""Awas+"": {""approved"": 6, ""pending"": 8}, ""Scholarship"": {""approved"": 12, ""pending"": 2}, ""Crop Insurance"": {""approved"": 6, ""pending"": 4}}"
35,Village-35,30,137,941841,887507,54334,"{""MGNREGA"": {""approved"": 5, ""pending"": 2}, ""Pension"": {""approved"": 6, ""pending"": 5}, ""PMAY"": {""approved"": 4, ""pending"": 2}, ""Scholarship"": {""approved"": 2, ""pending"": 3}, ""Awas+"": {""approved"": 5, ""pending"": 1}, ""Crop Insurance"": {""approved"": 0, ""pending"": 7}, ""Water+"": {""approved"": 3, ""pending"": 4}, ""Sanitation"": {""approved"": 1, ""pending"": 1}}"
36,Village-36,24,105,1963351,1722464,240887,"{""Scholarship"": {""approved"": 4, ""pending"": 2}, ""MGNREGA"": {""approved"": 2, ""pending"": 3}, ""Awas+"": {""approved"": 2, ""pending"": 1}, ""Crop Insurance"": {""approved"": 7, ""pending"": 1}, ""Pension"": {""approved"": 1, ""pending"": 2}, ""Water+"": {""approved"": 1, ""pending"": 1}, ""Sanitation"": {""approved"": 3, ""pending"": 2}, ""PMAY"": {""approved"": 2, ""pending"": 2}}"
37,Village-37,65,280,1489248,1166994,322254,"{""Sanitation"": {""approved"": 12, ""pending"": 6}, ""PMAY"": {""approved"": 12, ""pending"": 4}, ""Water+"": {""approved"": 5, ""pending"": 3}, ""Pension"": {""approved"": 5, ""pending"": 9}, ""MGNREGA"": {""approved"": 9, ""pending"": 7}, ""Scholarship"": {""approved"": 7, ""pending"": 5}, ""Crop Insurance"": {""approved"": 4, ""pending"": 3}, ""Awas+"": {""approved"": 6, ""pending"": 2}}"
38,Village-38,40,175,1403299,1295914,107385,"{""Scholarship"": {""approved"": 2, ""pending"": 2}, ""PMAY"": {""approved"": 5, ""pending"": 4}, ""Pension"": {""approved"": 7, ""pending"": 3}, ""Awas+"": {""approved"": 6, ""pending"": 4}, ""Sanitation"": {""approved"": 2, ""pending"": 3}, ""Water+"": {""approved"": 3, ""pending"": 1}, ""Crop Insurance"": {""approved"": 6, ""pending"": 4}, ""MGNREGA"": {""approved"": 4, ""pending"": 4}}"
39,Village-39,43,211,962667,630335,332332,"{""Awas+"": {""approved"": 7, ""pending"": 4}, ""Crop Insurance"": {""approved"": 5, ""pending"": 2}, ""Scholarship"": {""approved"": 10, ""pending"": 5}, ""Sanitation"": {""approved"": 5, ""pending"": 5}, ""Pension"": {""approved"": 1, ""pending"": 4}, ""PMAY"": {""approved"": 4, ""pending"": 1}, ""Water+"": {""approved"": 3, ""pending"": 3}, ""MGNREGA"": {""approved"": 5, ""pending"": 1}}"
40,Village-40,22,105,1239759,981182,258577,"{""Scholarship"": {""approved"": 1, ""pending"": 5}, ""Water+"": {""approved"": 1, ""pending"": 6}, ""Awas+"": {""approved"": 4, ""pending"": 2}, ""Pension"": {""approved"": 1, ""pending"": 2}, ""Crop Insurance"": {""approved"": 0, ""pending"": 3}, ""PMAY"": {""approved"": 2, ""pending"": 1}, ""Sanitation"": {""approved"": 0, ""pending"": 2}, ""MGNREGA"": {""approved"": 3, ""pending"": 1}}"
41,Village-41,30,138,1611019,1254778,356241,"{""Scholarship"": {""approved"": 2, ""pending"": 3}, ""Sanitation"": {""approved"": 4, ""pending"": 2}, ""Awas+"": {""approved"": 2, ""pending"": 5}, ""MGNREGA"": {""approved"": 4, ""pending"": 5}, ""Water+"": {""approved"": 5, ""pending"": 4}, ""Crop Insurance"": {""approved"": 3, ""pending"": 2}, ""Pension"": {""approved"": 4, ""pending"": 2}, ""PMAY"": {""approved"": 2, ""pending"": 1}}"
42,Village-42,49,221,1415722,1128928,286794,"{""PMAY"": {""approved"": 4, ""pending"": 6}, ""Awas+"": {""approved"": 4, ""pending"": 6}, ""Water+"": {""approved"": 12, ""pending"": 4}, ""Pension"": {""approved"": 4, ""pending"": 3}, ""Sanitation"": {""approved"": 4, ""pending"": 2}, ""Scholarship"": {""approved"": 7, ""pending"": 5}, ""MGNREGA"": {""approved"": 1, ""pending"": 4}, ""Crop Insurance"": {""approved"": 2, ""pending"": 4}}"
43,Village-43,45,213,918820,721663,197157,"{""Awas+"": {""approved"": 7, ""pending"": 2}, ""PMAY"": {""approved"": 1, ""pending"": 1}, ""Water+"": {""approved"": 5, ""pending"": 2}, ""Sanitation"": {""approved"": 4, ""pending"": 4}, ""Scholarship"": {""approved"": 6, ""pending"": 4}, ""MGNREGA"": {""approved"": 7, ""pending"": 5}, ""Crop Insurance"": {""approved"": 6, ""pending"": 1}, ""Pension"": {""approved"": 2, ""pending"": 4}}"
44,Village-44,31,142,953378,612372,341006,"{""Sanitation"": {""approved"": 6, ""pending"": 3}, ""Scholarship"": {""approved"": 5, ""pending"": 4}, ""Crop Insurance"": {""approved"": 5, ""pending"": 3}, ""Pension"": {""approved"": 3, ""pending"": 1}, ""Water+"": {""approved"": 2, ""pending"": 2}, ""Awas+"": {""approved"": 5, ""pending"": 3}, ""MGNREGA"": {""approved"": 6, ""pending"": 3}, ""PMAY"": {""approved"": 1, ""pending"": 2}}"
45,Village-45,36,145,1710585,1313268,397317,"{""Sanitation"": {""approved"": 7, ""pending"": 5}, ""Water+"": {""approved"": 5, ""pending"": 1}, ""MGNREGA"": {""approved"": 2, ""pending"": 2}, ""PMAY"": {""approved"": 2, ""pending"": 7}, ""Scholarship"": {""approved"": 1, ""pending"": 3}, ""Crop Insurance"": {""approved"": 3, ""pending"": 4}, ""Awas+"": {""approved"": 2, ""pending"": 6}, ""Pension"": {""approved"": 3, ""pending"": 0}}"
46,Village-46,23,105,1178193,726918,451275,"{""Sanitation"": {""approved"": 4, ""pending"": 1}, ""Crop Insurance"": {""approved"": 3, ""pending"": 4}, ""Awas+"": {""approved"": 3, ""pending"": 0}, ""MGNREGA"": {""approved"": 0, ""pending"": 4}, ""Scholarship"": {""approved"": 4, ""pending"": 1}, ""Water+"": {""approved"": 4, ""pending"": 2}, ""PMAY"": {""approved"": 0, ""pending"": 1}, ""Pension"": {""approved"": 1, ""pending"": 1}}"
47,Village-47,66,295,522113,337276,184837,"{""Pension"": {""approved"": 5, ""pending"": 5}, ""Awas+"": {""approved"": 9, ""pending"": 2}, ""Sanitation"": {""approved"": 4, ""pending"": 3}, ""Crop Insurance"": {""approved"": 6, ""pending"": 5}, ""Water+"": {""approved"": 7, ""pending"": 3}, ""MGNREGA"": {""approved"": 6, ""pending"": 5}, ""Scholarship"": {""approved"": 6, ""pending"": 5}, ""PMAY"": {""approved"": 5, ""pending"": 4}}"
48,Village-48,70,272,1442542,1146284,296258,"{""Sanitation"": {""approved"": 15, ""pending"": 8}, ""Water+"": {""approved"": 4, ""pending"": 5}, ""Awas+"": {""approved"": 4, ""pending"": 4}, ""Pension"": {""approved"": 10, ""pending"": 2}, ""PMAY"": {""approved"": 10, ""pending"": 6}, ""MGNREGA"": {""approved"": 11, ""pending"": 4}, ""Crop Insurance"": {""approved"": 6, ""pending"": 2}, ""Scholarship"": {""approved"": 4, ""pending"": 2}}"
49,Village-49,53,235,1917352,1735690,181662,"{""MGNREGA"": {""approved"": 7, ""pending"": 4}, ""Pension"": {""approved"": 9, ""pending"": 6}, ""PMAY"": {""approved"": 5, ""pending"": 4}, ""Sanitation"": {""approved"": 6, ""pending"": 3}, ""Water+"": {""approved"": 8, ""pending"": 7}, ""Scholarship"": {""approved"": 3, ""pending"": 7}, ""Awas+"": {""approved"": 10, ""pending"": 3}, ""Crop Insurance"": {""approved"": 7, ""pending"": 5}}"
50,Village-50,26,124,758107,451353,306754,"{""Crop Insurance"": {""approved"": 6, ""pending"": 1}, ""PMAY"": {""approved"": 9, ""pending"": 2}, ""Awas+"": {""approved"": 2, ""pending"": 2}, ""MGNREGA"": {""approved"": 5, ""pending"": 1}, ""Pension"": {""approved"": 2, ""pending"": 0}, ""Sanitation"": {""approved"": 3, ""pending"": 0}, ""Water+"": {""approved"": 1, ""pending"": 2}}"
51,Village-51,47,201,933104,900145,32959,"{""PMAY"": {""approved"": 7, ""pending"": 6}, ""Pension"": {""approved"": 3, ""pending"": 5}, ""Scholarship"": {""approved"": 11, ""pending"": 2}, ""Awas+"": {""approved"": 3, ""pending"": 2}, ""Sanitation"": {""approved"": 7, ""pending"": 2}, ""Water+"": {""approved"": 8, ""pending"": 4}, ""MGNREGA"": {""approved"": 7, ""pending"": 0}, ""Crop Insurance"": {""approved"": 6, ""pending"": 3}}"
52,Village-52,71,338,1181569,690561,491008,"{""Sanitation"": {""approved"": 6, ""pending"": 2}, ""Water+"": {""approved"": 6, ""pending"": 4}, ""Awas+"": {""approved"": 13, ""pending"": 7}, ""Crop Insurance"": {""approved"": 11, ""pending"": 8}, ""MGNREGA"": {""approved"": 6, ""pending"": 8}, ""PMAY"": {""approved"": 8, ""pending"": 4}, ""Pension"": {""approved"": 8, ""pending"": 6}, ""Scholarship"": {""approved"": 6, ""pending"": 2}}"
53,Village-53,78,359,2126541,1929258,197283,"{""Scholarship"": {""approved"": 12, ""pending"": 5}, ""Pension"": {""approved"": 9, ""pending"": 7}, ""MGNREGA"": {""approved"": 8, ""pending"": 10}, ""Sanitation"": {""approved"": 8, ""pending"": 6}, ""Awas+"": {""approved"": 10, ""pending"": 8}, ""Water+"": {""approved"": 9, ""pending"": 4}, ""Crop Insurance"": {""approved"": 7, ""pending"": 8}, ""PMAY"": {""approved"": 7, ""pending"": 4}}"
54,Village-54,64,316,523861,486348,37513,"{""Scholarship"": {""approved"": 7, ""pending"": 5}, ""Water+"": {""approved"": 8, ""pending"": 7}, ""Crop Insurance"": {""approved"": 10, ""pending"": 3}, ""Sanitation"": {""approved"": 5, ""pending"": 4}, ""Awas+"": {""approved"": 9, ""pending"": 5}, ""Pension"": {""approved"": 7, ""pending"": 8}, ""MGNREGA"": {""approved"": 4, ""pending"": 4}, ""PMAY"": {""approved"": 6, ""pending"": 4}}"
55,Village-55,78,346,1242952,980492,262460,"{""MGNREGA"": {""approved"": 10, ""pending"": 7}, ""Sanitation"": {""approved"": 8, ""pending"": 5}, ""Crop Insurance"": {""approved"": 9, ""pending"": 11}, ""PMAY"": {""approved"": 10, ""pending"": 8}, ""Scholarship"": {""approved"": 9, ""pending"": 3}, ""Water+"": {""approved"": 11, ""pending"": 4}, ""Awas+"": {""approved"": 10, ""pending"": 7}, ""Pension"": {""approved"": 6, ""pending"": 2}}"
56,Village-56,30,148,1801666,1401621,400045,"{""Sanitation"": {""approved"": 5, ""pending"": 5}, ""Awas+"": {""approved"": 5, ""pending"": 6}, ""Crop Insurance"": {""approved"": 0, ""pending"": 3}, ""MGNREGA"": {""approved"": 4, ""pending"": 4}, ""Pension"": {""approved"": 5, ""pending"": 2}, ""PMAY"": {""approved"": 3, ""pending"": 2}, ""Water+"": {""approved"": 2, ""pending"": 2}, ""Scholarship"": {""approved"": 4, ""pending"": 4}}"
57,Village-57,48,224,1074561,841227,233334,"{""Scholarship"": {""approved"": 5, ""pending"": 4}, ""Sanitation"": {""approved"": 5, ""pending"": 4}, ""PMAY"": {""approved"": 4, ""pending"": 4}, ""Crop Insurance"": {""approved"": 6, ""pending"": 4}, ""Awas+"": {""approved"": 4, ""pending"": 6}, ""Water+"": {""approved"": 5, ""pending"": 4}, ""MGNREGA"": {""approved"": 3, ""pending"": 0}, ""Pension"": {""approved"": 5, ""pending"": 1}}"
58,Village-58,28,110,597037,130304,466733,"{""Awas+"": {""approved"": 2, ""pending"": 4}, ""Water+"": {""approved"": 2, ""pending"": 4}, ""Crop Insurance"": {""approved"": 2, ""pending"": 0}, ""Sanitation"": {""approved"": 3, ""pending"": 2}, ""Scholarship"": {""approved"": 4, ""pending"": 1}, ""Pension"": {""approved"": 3, ""pending"": 1}, ""MGNREGA"": {""approved"": 3, ""pending"": 3}, ""PMAY"": {""approved"": 2, ""pending"": 1}}"
59,Village-59,20,81,716252,323558,392694,"{""Crop Insurance"": {""approved"": 2, ""pending"": 4}, ""Sanitation"": {""approved"": 2, ""pending"": 1}, ""Awas+"": {""approved"": 1, ""pending"": 0}, ""Pension"": {""approved"": 3, ""pending"": 0}, ""PMAY"": {""approved"": 4, ""pending"": 1}, ""MGNREGA"": {""approved"": 4, ""pending"": 0}, ""Scholarship"": {""approved"": 1, ""pending"": 1}, ""Water+"": {""approved"": 1, ""pending"": 0}}"
60,Village-60,66,311,2006388,1716780,289608,"{""PMAY"": {""approved"": 8, ""pending"": 5}, ""Water+"": {""approved"": 11, ""pending"": 4}, ""Sanitation"": {""approved"": 9, ""pending"": 10}, ""Crop Insurance"": {""approved"": 4, ""pending"": 10}, ""Pension"": {""approved"": 5, ""pending"": 4}, ""Awas+"": {""approved"": 6, ""pending"": 6}, ""MGNREGA"": {""approved"": 8, ""pending"": 2}, ""Scholarship"": {""approved"": 6, ""pending"": 1}}"
61,Village-61,36,160,1707182,1383873,323309,"{""Crop Insurance"": {""approved"": 4, ""pending"": 1}, ""Awas+"": {""approved"": 2, ""pending"": 4}, ""Pension"": {""approved"": 5, ""pending"": 3}, ""Sanitation"": {""approved"": 3, ""pending"": 5}, ""Water+"": {""approved"": 7, ""pending"": 3}, ""Scholarship"": {""approved"": 2, ""pending"": 3}, ""PMAY"": {""approved"": 0, ""pending"": 4}, ""MGNREGA"": {""approved"": 2, ""pending"": 2}}"
62,Village-62,45,201,624838,279008,345830,"{""Awas+"": {""approved"": 6, ""pending"": 3}, ""PMAY"": {""approved"": 9, ""pending"": 4}, ""Scholarship"": {""approved"": 4, ""pending"": 5}, ""MGNREGA"": {""approved"": 1, ""pending"": 2}, ""Water+"": {""approved"": 5, ""pending"": 2}, ""Pension"": {""approved"": 5, ""pending"": 2}, ""Crop Insurance"": {""approved"": 6, ""pending"": 4}, ""Sanitation"": {""approved"": 4, ""pending"": 2}}"
63,Village-63,40,176,1033040,1020745,12295,"{""Scholarship"": {""approved"": 7, ""pending"": 4}, ""Sanitation"": {""approved"": 8, ""pending"": 3}, ""Crop Insurance"": {""approved"": 2, ""pending"": 5}, ""Pension"": {""approved"": 1, ""pending"": 4}, ""Awas+"": {""approved"": 3, ""pending"": 2}, ""MGNREGA"": {""approved"": 2, ""pending"": 2}, ""Water+"": {""approved"": 4, ""pending"": 2}, ""PMAY"": {""approved"": 2, ""pending"": 4}}"
64,Village-64,47,219,767490,684911,82579,"{""Water+"": {""approved"": 11, ""pending"": 1}, ""Scholarship"": {""approved"": 7, ""pending"": 5}, ""Sanitation"": {""approved"": 2, ""pending"": 7}, ""Pension"": {""approved"": 6, ""pending"": 5}, ""MGNREGA"": {""approved"": 9, ""pending"": 5}, ""Awas+"": {""approved"": 7, ""pending"": 3}, ""Crop Insurance"": {""approved"": 6, ""pending"": 2}, ""PMAY"": {""approved"": 2, ""pending"": 4}}"
65,Village-65,37,164,601138,206501,394637,"{""Scholarship"": {""approved"": 0, ""pending"": 4}, ""MGNREGA"": {""approved"": 5, ""pending"": 3}, ""Awas+"": {""approved"": 3, ""pending"": 3}, ""Crop Insurance"": {""approved"": 3, ""pending"": 4}, ""PMAY"": {""approved"": 4, ""pending"": 6}, ""Sanitation"": {""approved"": 6, ""pending"": 2}, ""Pension"": {""approved"": 4, ""pending"": 2}, ""Water+"": {""approved"": 5, ""pending"": 1}}"
66,Village-66,75,347,1159090,887184,271906,"{""Sanitation"": {""approved"": 11, ""pending"": 7}, ""PMAY"": {""approved"": 12, ""pending"": 7}, ""MGNREGA"": {""approved"": 7, ""pending"": 3}, ""Water+"": {""approved"": 8, ""pending"": 11}, ""Scholarship"": {""approved"": 8, ""pending"": 4}, ""Crop Insurance"": {""approved"": 7, ""pending"": 6}, ""Pension"": {""approved"": 6, ""pending"": 5}, ""Awas+"": {""approved"": 4, ""pending"": 6}}"
67,Village-67,32,135,1124792,628161,496631,"{""Pension"": {""approved"": 3, ""pending"": 1}, ""Sanitation"": {""approved"": 3, ""pending"": 2}, ""MGNREGA"": {""approved"": 4, ""pending"": 2}, ""Awas+"": {""approved"": 4, ""pending"": 0}, ""PMAY"": {""approved"": 4, ""pending"": 3}, ""Crop Insurance"": {""approved"": 4, ""pending"": 2}, ""Scholarship"": {""approved"": 1, ""pending"": 2}, ""Water+"": {""approved"": 0, ""pending"": 1}}"
68,Village-68,60,260,434101,306625,127476,"{""Awas+"": {""approved"": 5, ""pending"": 10}, ""Pension"": {""approved"": 8, ""pending"": 5}, ""Sanitation"": {""approved"": 10, ""pending"": 6}, ""PMAY"": {""approved"": 8, ""pending"": 4}, ""Crop Insurance"": {""approved"": 8, ""pending"": 1}, ""Scholarship"": {""approved"": 4, ""pending"": 5}, ""Water+"": {""approved"": 4, ""pending"": 4}, ""MGNREGA"": {""approved"": 6, ""pending"": 2}}"
69,Village-69,29,141,562659,440512,122147,"{""Water+"": {""approved"": 8, ""pending"": 1}, ""Scholarship"": {""approved"": 1, ""pending"": 4}, ""Crop Insurance"": {""approved"": 5, ""pending"": 3}, ""MGNREGA"": {""approved"": 4, ""pending"": 0}, ""Sanitation"": {""approved"": 3, ""pending"": 2}, ""Awas+"": {""approved"": 0, ""pending"": 2}, ""Pension"": {""approved"": 3, ""pending"": 2}, ""PMAY"": {""approved"": 2, ""pending"": 0}}"
70,Village-70,22,99,1814730,1317446,497284,"{""Pension"": {""approved"": 3, ""pending"": 2}, ""PMAY"": {""approved"": 3, ""pending"": 3}, ""Scholarship"": {""approved"": 4, ""pending"": 4}, ""Sanitation"": {""approved"": 2, ""pending"": 1}, ""Crop Insurance"": {""approved"": 3, ""pending"": 2}, ""Water+"": {""approved"": 2, ""pending"": 0}, ""MGNREGA"": {""approved"": 7, ""pending"": 4}}"
71,Village-71,62,271,1800513,1753982,46531,"{""MGNREGA"": {""approved"": 8, ""pending"": 8}, ""Water+"": {""approved"": 5, ""pending"": 5}, ""Sanitation"": {""approved"": 3, ""pending"": 4}, ""Crop Insurance"": {""approved"": 6, ""pending"": 9}, ""Scholarship"": {""approved"": 6, ""pending"": 2}, ""PMAY"": {""approved"": 6, ""pending"": 4}, ""Pension"": {""approved"": 4, ""pending"": 7}, ""Awas+"": {""approved"": 7, ""pending"": 3}}"
72,Village-72,69,314,1307848,1037459,270389,"{""Pension"": {""approved"": 7, ""pending"": 7}, ""Water+"": {""approved"": 8, ""pending"": 4}, ""MGNREGA"": {""approved"": 11, ""pending"": 11}, ""Crop Insurance"": {""approved"": 7, ""pending"": 7}, ""Scholarship"": {""approved"": 7, ""pending"": 6}, ""Awas+"": {""approved"": 6, ""pending"": 7}, ""Sanitation"": {""approved"": 7, ""pending"": 3}, ""PMAY"": {""approved"": 10, ""pending"": 3}}"
73,Village-73,48,230,1662976,1214304,448672,"{""Water+"": {""approved"": 4, ""pending"": 3}, ""Awas+"": {""approved"": 8, ""pending"": 4}, ""Pension"": {""approved"": 6, ""pending"": 2}, ""Crop Insurance"": {""approved"": 3, ""pending"": 2}, ""Sanitation"": {""approved"": 8, ""pending"": 4}, ""Scholarship"": {""approved"": 4, ""pending"": 1}, ""PMAY"": {""approved"": 2, ""pending"": 2}, ""MGNREGA"": {""approved"": 7, ""pending"": 1}}"
74,Village-74,70,339,1896711,1710398,186313,"{""Pension"": {""approved"": 9, ""pending"": 5}, ""MGNREGA"": {""approved"": 8, ""pending"": 5}, ""Awas+"": {""approved"": 9, ""pending"": 4}, ""Crop Insurance"": {""approved"": 8, ""pending"": 3}, ""Scholarship"": {""approved"": 9, ""pending"": 4}, ""PMAY"": {""approved"": 5, ""pending"": 8}, ""Water+"": {""approved"": 11, ""pending"": 5}, ""Sanitation"": {""approved"": 8, ""pending"": 3}}"
75,Village-75,39,183,1601211,1546366,54845,"{""Crop Insurance"": {""approved"": 5, ""pending"": 4}, ""Sanitation"": {""approved"": 3, ""pending"": 3}, ""PMAY"": {""approved"": 7, ""pending"": 4}, ""Pension"": {""approved"": 4, ""pending"": 3}, ""Awas+"": {""approved"": 5, ""pending"": 3}, ""Scholarship"": {""approved"": 4, ""pending"": 4}, ""Water+"": {""approved"": 4, ""pending"": 0}, ""MGNREGA"": {""approved"": 3, ""pending"": 2}}"
76,Village-76,40,163,1556948,1290664,266284,"{""Sanitation"": {""approved"": 5, ""pending"": 1}, ""PMAY"": {""approved"": 4, ""pending"": 3}, ""Water+"": {""approved"": 2, ""pending"": 5}, ""Pension"": {""approved"": 4, ""pending"": 2}, ""Scholarship"": {""approved"": 4, ""pending"": 4}, ""Awas+"": {""approved"": 0, ""pending"": 3}, ""MGNREGA"": {""approved"": 2, ""pending"": 2}, ""Crop Insurance"": {""approved"": 2, ""pending"": 5}}"
77,Village-77,73,349,543724,376872,166852,"{""Pension"": {""approved"": 8, ""pending"": 7}, ""Awas+"": {""approved"": 8, ""pending"": 7}, ""Water+"": {""approved"": 6, ""pending"": 5}, ""Sanitation"": {""approved"": 10, ""pending"": 3}, ""Crop Insurance"": {""approved"": 5, ""pending"": 9}, ""Scholarship"": {""approved"": 8, ""pending"": 6}, ""PMAY"": {""approved"": 13, ""pending"": 5}, ""MGNREGA"": {""approved"": 5, ""pending"": 1}}"
78,Village-78,37,174,1975029,1674254,300775,"{""MGNREGA"": {""approved"": 9, ""pending"": 4}, ""Awas+"": {""approved"": 2, ""pending"": 2}, ""Pension"": {""approved"": 6, ""pending"": 4}, ""Scholarship"": {""approved"": 6, ""pending"": 0}, ""Crop Insurance"": {""approved"": 3, ""pending"": 0}, ""Water+"": {""approved"": 5, ""pending"": 1}, ""PMAY"": {""approved"": 6, ""pending"": 1}, ""Sanitation"": {""approved"": 3, ""pending"": 3}}"
79,Village-79,57,271,1004964,978512,26452,"{""PMAY"": {""approved"": 5, ""pending"": 7}, ""Sanitation"": {""approved"": 7, ""pending"": 7}, ""Crop Insurance"": {""approved"": 3, ""pending"": 3}, ""MGNREGA"": {""approved"": 6, ""pending"": 2}, ""Awas+"": {""approved"": 4, ""pending"": 6}, ""Scholarship"": {""approved"": 5, ""pending"": 9}, ""Water+"": {""approved"": 6, ""pending"": 7}, ""Pension"": {""approved"": 4, ""pending"": 4}}"
80,Village-80,60,277,1036730,1023771,12959,"{""Awas+"": {""approved"": 8, ""pending"": 2}, ""Water+"": {""approved"": 12, ""pending"": 3}, ""Sanitation"": {""approved"": 6, ""pending"": 4}, ""MGNREGA"": {""approved"": 7, ""pending"": 4}, ""PMAY"": {""approved"": 1, ""pending"": 8}, ""Crop Insurance"": {""approved"": 5, ""pending"": 2}, ""Pension"": {""approved"": 8, ""pending"": 1}, ""Scholarship"": {""approved"": 9, ""pending"": 5}}"
81,Village-81,72,300,725191,247905,477286,"{""Sanitation"": {""approved"": 10, ""pending"": 5}, ""MGNREGA"": {""approved"": 8, ""pending"": 4}, ""Crop Insurance"": {""approved"": 11, ""pending"": 4}, ""PMAY"": {""approved"": 10, ""pending"": 4}, ""Awas+"": {""approved"": 9, ""pending"": 7}, ""Scholarship"": {""approved"": 15, ""pending"": 9}, ""Water+"": {""approved"": 8, ""pending"": 3}, ""Pension"": {""approved"": 10, ""pending"": 7}}"
82,Village-82,43,173,623826,233207,390619,"{""PMAY"": {""approved"": 8, ""pending"": 3}, ""Sanitation"": {""approved"": 6, ""pending"": 5}, ""Scholarship"": {""approved"": 6, ""pending"": 1}, ""Awas+"": {""approved"": 11, ""pending"": 2}, ""Water+"": {""approved"": 5, ""pending"": 5}, ""Pension"": {""approved"": 5, ""pending"": 2}, ""Crop Insurance"": {""approved"": 5, ""pending"": 4}, ""MGNREGA"": {""approved"": 1, ""pending"": 1}}"
83,Village-83,20,92,1353776,1124292,229484,"{""Awas+"": {""approved"": 1, ""pending"": 3}, ""Scholarship"": {""approved"": 7, ""pending"": 2}, ""Water+"": {""approved"": 2, ""pending"": 1}, ""PMAY"": {""approved"": 5, ""pending"": 1}, ""Pension"": {""approved"": 2, ""pending"": 4}, ""Crop Insurance"": {""approved"": 3, ""pending"": 0}, ""Sanitation"": {""approved"": 2, ""pending"": 0}, ""MGNREGA"": {""approved"": 1, ""pending"": 2}}"
84,Village-84,63,305,874778,782168,92610,"{""Pension"": {""approved"": 4, ""pending"": 10}, ""Scholarship"": {""approved"": 10, ""pending"": 3}, ""MGNREGA"": {""approved"": 7, ""pending"": 3}, ""Water+"": {""approved"": 7, ""pending"": 3}, ""Awas+"": {""approved"": 6, ""pending"": 3}, ""Crop Insurance"": {""approved"": 11, ""pending"": 5}, ""PMAY"": {""approved"": 5, ""pending"": 4}, ""Sanitation"": {""approved"": 5, ""pending"": 5}}"
85,Village-85,20,73,1609408,1243651,365757,"{""Scholarship"": {""approved"": 2, ""pending"": 1}, ""MGNREGA"": {""approved"": 2, ""pending"": 1}, ""Crop Insurance"": {""approved"": 3, ""pending"": 2}, ""Pension"": {""approved"": 5, ""pending"": 0}, ""Sanitation"": {""approved"": 4, ""pending"": 2}, ""PMAY"": {""approved"": 2, ""pending"": 0}, ""Awas+"": {""approved"": 2, ""pending"": 1}, ""Water+"": {""approved"": 1, ""pending"": 2}}"
86,Village-86,77,334,860727,500412,360315,"{""Crop Insurance"": {""approved"": 12, ""pending"": 6}, ""MGNREGA"": {""approved"": 10, ""pending"": 4}, ""Awas+"": {""approved"": 10, ""pending"": 10}, ""Scholarship"": {""approved"": 8, ""pending"": 5}, ""Pension"": {""approved"": 9, ""pending"": 8}, ""Water+"": {""approved"": 6, ""pending"": 5}, ""PMAY"": {""approved"": 13, ""pending"": 4}, ""Sanitation"": {""approved"": 5, ""pending"": 9}}"
87,Village-87,31,141,309569,222515,87054,"{""MGNREGA"": {""approved"": 5, ""pending"": 2}, ""PMAY"": {""approved"": 6, ""pending"": 1}, ""Water+"": {""approved"": 7, ""pending"": 3}, ""Awas+"": {""approved"": 4, ""pending"": 2}, ""Crop Insurance"": {""approved"": 4, ""pending"": 1}, ""Sanitation"": {""approved"": 2, ""pending"": 2}, ""Pension"": {""approved"": 1, ""pending"": 1}, ""Scholarship"": {""approved"": 0, ""pending"": 1}}"
88,Village-88,62,299,397436,251478,145958,"{""MGNREGA"": {""approved"": 11, ""pending"": 6}, ""Awas+"": {""approved"": 5, ""pending"": 5}, ""PMAY"": {""approved"": 5, ""pending"": 3}, ""Scholarship"": {""approved"": 7, ""pending"": 4}, ""Pension"": {""approved"": 4, ""pending"": 8}, ""Sanitation"": {""approved"": 9, ""pending"": 1}, ""Crop Insurance"": {""approved"": 8, ""pending"": 3}, ""Water+"": {""approved"": 7, ""pending"": 5}}"
89,Village-89,32,147,388007,201121,186886,"{""Crop Insurance"": {""approved"": 2, ""pending"": 4}, ""Water+"": {""approved"": 2, ""pending"": 4}, ""Awas+"": {""approved"": 5, ""pending"": 5}, ""Scholarship"": {""approved"": 2, ""pending"": 1}, ""PMAY"": {""approved"": 3, ""pending"": 1}, ""Pension"": {""approved"": 5, ""pending"": 2}, ""MGNREGA"": {""approved"": 4, ""pending"": 4}, ""Sanitation"": {""approved"": 5, ""pending"": 1}}"
90,Village-90,73,327,1149721,937384,212337,"{""MGNREGA"": {""approved"": 6, ""pending"": 3}, ""Pension"": {""approved"": 16, ""pending"": 3}, ""PMAY"": {""approved"": 12, ""pending"": 6}, ""Sanitation"": {""approved"": 9, ""pending"": 7}, ""Water+"": {""approved"": 12, ""pending"": 6}, ""Awas+"": {""approved"": 4, ""pending"": 4}, ""Crop Insurance"": {""approved"": 5, ""pending"": 3}, ""Scholarship"": {""approved"": 8, ""pending"": 2}}"
91,Village-91,44,186,1264386,1051175,213211,"{""Pension"": {""approved"": 5, ""pending"": 3}, ""Awas+"": {""approved"": 2, ""pending"": 4}, ""MGNREGA"": {""approved"": 5, ""pending"": 5}, ""Crop Insurance"": {""approved"": 8, ""pending"": 7}, ""Water+"": {""approved"": 6, ""pending"": 6}, ""Scholarship"": {""approved"": 2, ""pending"": 2}, ""Sanitation"": {""approved"": 5, ""pending"": 2}, ""PMAY"": {""approved"": 1, ""pending"": 2}}"
92,Village-92,64,289,2058474,1694009,364465,"{""MGNREGA"": {""approved"": 11, ""pending"": 3}, ""Sanitation"": {""approved"": 13, ""pending"": 7}, ""Awas+"": {""approved"": 5, ""pending"": 7}, ""Water+"": {""approved"": 9, ""pending"": 4}, ""Crop Insurance"": {""approved"": 7, ""pending"": 6}, ""PMAY"": {""approved"": 8, ""pending"": 3}, ""Pension"": {""approved"": 1, ""pending"": 1}, ""Scholarship"": {""approved"": 5, ""pending"": 1}}"
93,Village-93,67,298,1481417,1281732,199685,"{""Awas+"": {""approved"": 6, ""pending"": 2}, ""MGNREGA"": {""approved"": 8, ""pending"": 8}, ""Crop Insurance"": {""approved"": 6, ""pending"": 2}, ""Water+"": {""approved"": 3, ""pending"": 7}, ""Sanitation"": {""approved"": 8, ""pending"": 6}, ""Scholarship"": {""approved"": 6, ""pending"": 4}, ""Pension"": {""approved"": 6, ""pending"": 5}, ""PMAY"": {""approved"": 9, ""pending"": 4}}"
94,Village-94,74,362,781482,600414,181068,"{""Pension"": {""approved"": 7, ""pending"": 6}, ""Sanitation"": {""approved"": 11, ""pending"": 6}, ""PMAY"": {""approved"": 8, ""pending"": 2}, ""Awas+"": {""approved"": 9, ""pending"": 5}, ""Crop Insurance"": {""approved"": 7, ""pending"": 9}, ""Water+"": {""approved"": 7, ""pending"": 5}, ""Scholarship"": {""approved"": 9, ""pending"": 8}, ""MGNREGA"": {""approved"": 3, ""pending"": 8}}"
95,Village-95,54,222,652075,540307,111768,"{""Crop Insurance"": {""approved"": 4, ""pending"": 6}, ""Sanitation"": {""approved"": 5, ""pending"": 2}, ""Pension"": {""approved"": 9, ""pending"": 4}, ""Awas+"": {""approved"": 8, ""pending"": 1}, ""Scholarship"": {""approved"": 9, ""pending"": 5}, ""MGNREGA"": {""approved"": 6, ""pending"": 6}, ""PMAY"": {""approved"": 8, ""pending"": 2}, ""Water+"": {""approved"": 12, ""pending"": 5}}"
96,Village-96,58,262,515004,336286,178718,"{""Crop Insurance"": {""approved"": 4, ""pending"": 4}, ""Pension"": {""approved"": 12, ""pending"": 3}, ""Water+"": {""approved"": 6, ""pending"": 5}, ""PMAY"": {""approved"": 8, ""pending"": 7}, ""Scholarship"": {""approved"": 7, ""pending"": 2}, ""MGNREGA"": {""approved"": 5, ""pending"": 3}, ""Sanitation"": {""approved"": 9, ""pending"": 4}, ""Awas+"": {""approved"": 9, ""pending"": 4}}"
97,Village-97,40,160,1749854,1504698,245156,"{""Pension"": {""approved"": 4, ""pending"": 7}, ""Sanitation"": {""approved"": 11, ""pending"": 4}, ""Crop Insurance"": {""approved"": 4, ""pending"": 0}, ""Awas+"": {""approved"": 5, ""pending"": 0}, ""PMAY"": {""approved"": 1, ""pending"": 2}, ""Scholarship"": {""approved"": 2, ""pending"": 3}, ""MGNREGA"": {""approved"": 10, ""pending"": 3}, ""Water+"": {""approved"": 1, ""pending"": 4}}"
98,Village-98,26,114,1725796,1437545,288251,"{""Crop Insurance"": {""approved"": 8, ""pending"": 2}, ""Water+"": {""approved"": 2, ""pending"": 1}, ""Pension"": {""approved"": 1, ""pending"": 3}, ""Scholarship"": {""approved"": 1, ""pending"": 1}, ""PMAY"": {""approved"": 1, ""pending"": 2}, ""MGNREGA"": {""approved"": 4, ""pending"": 1}, ""Awas+"": {""approved"": 3, ""pending"": 3}, ""Sanitation"": {""approved"": 3, ""pending"": 0}}"
99,Village-99,33,146,1931019,1699919,231100,"{""Sanitation"": {""approved"": 5, ""pending"": 3}, ""MGNREGA"": {""approved"": 3, ""pending"": 3}, ""Pension"": {""approved"": 5, ""pending"": 2}, ""PMAY"": {""approved"": 7, ""pending"": 0}, ""Crop Insurance"": {""approved"": 2, ""pending"": 5}, ""Water+"": {""approved"": 3, ""pending"": 0}, ""Scholarship"": {""approved"": 2, ""pending"": 4}, ""Awas+"": {""approved"": 4, ""pending"": 3}}"
100,Village-100,24,114,2057203,1882191,175012,"{""PMAY"": {""approved"": 3, ""pending"": 2}, ""Scholarship"": {""approved"": 5, ""pending"": 2}, ""Sanitation"": {""approved"": 0, ""pending"": 7}, ""Awas+"": {""approved"": 5, ""pending"": 3}, ""Crop Insurance"": {""approved"": 1, ""pending"": 2}, ""Pension"": {""approved"": 5, ""pending"": 3}, ""MGNREGA"": {""approved"": 1, ""pending"": 3}, ""Water+"": {""approved"": 2, ""pending"": 0}}"
